#,#,#,#,#,#,#,#,#,#,#,#,#,#,#
#,#,#,#,#,#,#,#,#,#,#,#,#,#,#
#,#,,O,,*,,,*,,*,*,,#,#
#,#,,,,*,,,*,*,*,*,*,#,#
#,#,,,*,*,*,,*,,*,*,,#,#
#,#,*,*,*,*,*,*,*,*,*,*,*,#,#
#,#,,,,*,,,,*,,,,#,#
#,#,,*,,*,,*,,*,,,,#,#
#,#,,,*,*,,*,,*,,,,#,#
#,#,*,*,*,*,*,*,*,,,*,,#,#
#,#,,,,,*,,,,,,,#,#
#,#,,*,,,*,*,*,*,*,*,*,#,#
#,#,,*,,,,*,*,,,,P,#,#
#,#,#,#,#,#,#,#,#,#,#,#,#,#,#
#,#,#,#,#,#,#,#,#,#,#,#,#,#,#