#,#,#,#,#,#,#,#,#,#,#,#,#,#,#
#,#,#,#,#,#,#,#,#,#,#,,,O,#
#,#,,,,,,,*,,,,,,#
#,#,,,,,,,,,,,,,#
#,#,,,,,,,,,,,,,#
#,#,,,,,,,,,,,,,#
#,#,,,,,,,,,,,,,#
#,#,,*,,,,P,,*,,,,,#
#,#,,,,,,,,,,,,,#
#,#,,*,,,,g,,,,,,,#
#,#,,,,,,,,,,,,,#
#,#,,,,,,*,,,,,,,#
#,#,,,,,,,,,,,,,#
#,#,#,#,#,#,#,#,#,#,#,#,#,#,#
#,#,#,#,#,#,#,#,#,#,#,#,#,#,#