#,#,#,#,#,#,#,#,#,#,#,#,#,#,#
#,#,#,#,#,#,#,#,#,#,#,,,O,#
#,#,,,,*,,,*,,*,*,,,#
#,#,,,,*,,,*,,*,,*,,#
#,#,,,,*,,,*,,*,*,,,#
#,#,*,*,*,*,*,*,*,*,*,*,*,*,#
#,#,,,,*,,,,*,,,*,,#
#,#,,*,,*,,P,,*,,*,,,#
#,#,,,,*,,,,*,,*,,,#
#,#,*,*,*,*,*,*,*,*,,*,,,#
#,#,,*,,,*,,,,,,,,#
#,#,,*,,,*,*,*,*,*,*,*,*,#
#,#,,*,,,*,,,,,,,,#
#,#,#,#,#,#,#,#,#,#,#,#,#,#,#
#,#,#,#,#,#,#,#,#,#,#,#,#,#,#