#,#,#,#,#,#,#,#,#,#,#,#,#,#,#
#,#,#,#,#,#,#,#,#,#,#,#,#,#,#
#,#,,,,*,,,*,,*,,*,#,#
#,#,,*,,*,,O,,*,,*,,#,#
#,#,,,*,*,*,,*,,*,,*,#,#
#,#,B,*,*,*,*,*,*,*,*,*,*,#,#
#,#,,,,,,,,*,,,,#,#
#,#,,,,,,*,,*,,b,,#,#
#,#,,,*,*,*,*,*,*,*,,,#,#
#,#,*,*,*,*,*,*,*,,,*,*,#,#
#,#,,,*,,*,,*,*,,,,#,#
#,#,,*,*,,*,,*,,*,*,*,#,#
#,#,,*,,,*,P,*,,,,,#,#
#,#,#,#,#,#,#,#,#,#,#,#,#,#,#
#,#,#,#,#,#,#,#,#,#,#,#,#,#,#